1111111111111111111111
1000000000000000000001
1P000C100C0000000E0001
1000001000011000000001
10000C000001C00000C001
1111111111111111111111