111111111111111
1E1C0000010P011
1000010C0000101
111111111111111