111111111111
1000C0000001
1P0000E00001
1111111111111