11111111111
1P00E00C1C1
10000C00001
11111111111