1111111111111111111111
1000000000000000010001
1P000C100C0000001E0001
1000001000011000010001
10000C000001C00C00C001
1111111111111111111111