111111111
1001E0011
10C0000C1
1P00C0011
111111111