11111111111
1000000E001
1P010C000C1
11111111111